20_xp
___xx_xxx____x_
x_x_xx___x_x___
_____x_________
_________x_____
_xx_____x____x_
______x____xx__
__xx_x___x_x___
__x__x_x_x___xx
x_____x__xx___x
x______________
_x_xx___x_xx_x_
x_______x_xx___
_x___x_____xxx_
__x___x_x___xx_
x___x_x________
_______________
__xx___x__x____
x_x_________x__
x_____x____x___
________xx_____
