xxx.....o.oo.o.
xxx...o....o...
xxx.o...ooo.o.o
o.o......o.....
..........o....
..o..o........o
...oo...o..oo..
o.o.o..oo......
.o..o.........o
...o.....o.....
